{
    "K": "US",
    "AA": "US",
    "AB": "US",
    "KL7": "US",
    "KH6": "US",
    "VE": "CA",
    "VO": "CA",
    "CY": "CA",
    "CF": "CA",
    "CG": "CA",
    "LU": "AR",
    "PY": "BR",
    "CX": "UY",
    "CE": "CL",
    "XE": "MX",
    "YV": "VE",
    "HC": "EC",
    "OA": "PE",
    "HP": "PA",
    "HJ": "CO",
    "PZ": "SR",
    "YN": "NI",
    "G": "GB",
    "EI": "IE",
    "PA": "NL",
    "ON": "BE",
    "F": "FR",
    "DL": "DE",
    "OE": "AT",
    "I": "IT",
    "EA": "ES",
    "CT": "PT",
    "SM": "SE",
    "OH": "FI",
    "LA": "NO",
    "OK": "CZ",
    "OM": "SK",
    "S5": "SI",
    "YU": "RS",
    "4O": "ME",
    "YT": "RS",
    "HA": "HU",
    "YO": "RO",
    "LY": "LT",
    "YL": "EE",
    "ES": "EE",
    "ZM": "PL",
    "SV": "GR",
    "TC": "CY",
    "9A": "HR",
    "4X": "IL",
    "E7": "BA",
    "OZ": "DK",
    "TF": "IS",
    "HB": "CH",
    "ZS": "ZA",
    "5Z": "KE",
    "9J": "ZM",
    "CN": "MA",
    "3V": "TN",
    "7O": "YE",
    "5T": "DZ",
    "3B8": "MU",
    "7X": "DZ",
    "C5": "GW",
    "D2": "AO",
    "T9": "SO",
    "Z2": "ZW",
    "5N": "NG",
    "A2": "BH",
    "A4": "OM",
    "JA": "JP",
    "VK": "AU",
    "ZL": "NZ",
    "YB": "ID",
    "VU": "IN",
    "IN": "IN",
    "HS": "TH",
    "XU": "KH",
    "BY": "CN",
    "BA": "CN",
    "BD": "CN",
    "BG": "CN",
    "BM": "CN",
    "BO": "CN",
    "BX": "CN",
    "VR": "HK",
    "XA": "MX",
    "XR": "MX",
    "4S": "LK",
    "9M": "MY",
    "XW": "LA",
    "XV": "VN",
    "HL": "KR",
    "TT": "MM",
    "DU": "PH",
    "A6": "AE",
    "HZ": "SA",
    "JY": "JO",
    "A7": "QA",
    "CY9": "CA",
    "CE0": "UM",
    "KH0": "MP",
    "KH2": "GU",
    "FO": "PF",
    "FM": "MQ",
    "FG": "GF",
    "FK": "NC",
    "FS": "BL",
    "FW": "WF",
    "FY": "GF",
    "PJ4": "BQ",
    "PJ5": "BQ",
    "PJ6": "BQ"
}
